11111111111111111111111111111111
10000000000000000000000000000001
10000000000000000000000000000001
10011111111111000000000000000001
10012222222221000000000000000001
10012222222221000000000000000001
10012222222221000000000000000001
10011122222111000000000000000001
10000002220000000000000000000001
10000002220000000000000000000001
10000002220000000000000000000001
10000002220000000001111110000001
10000002220000000002222210000001
10000002222222222222222210000001
10000002222222222222222210000001
10000000000000222002222210000001
10000000000000222000000000000001
10000000000000222000000000000001
10000000000000222000000000000001
10000000000000222000000000000001
10000000000000222000000000000001
10000000000000222000000000000001
10000000000000222000000000000001
10000000000000222000000000000001
10000000000000222000000000000001
10000000000000222000000000000001
10000000000000222000000000000001
10000000000000222000000000000001
10000000000000222000000000000001
10000000000000222000000000000001
10000000000000222000000000000001
10000000000000222000000000000001
10000000000000222000000000000001
10000000000000222000000000000001
10000000000000222000000000000001
10000000000022222220000000000001
10000000000021111120000000000001
12222222222221333122222222222221
12222222222221333122222222222221
12222222222221333122222222222221
10000000000021111120000000000001
10000000000022222220000000000001
10000000000000222000000000000001
14400000000000222000000000000001
14400000000000222000000000000001
14000000000000222000044400000001
10000000000000222000444440000001
11111111111111111111111111111111